Species	Commodities
African cassava mosaic begomovirus	Cassava
African cassava mosaic virus	Cassava
African peanut clump pecluvirus	Clonal grasses
African peanut clump virus	Clonal grasses
Agropyron mosaic potyvirus	Clonal grasses
Agropyron mosaic virus	Clonal grasses
Alfalfa mosaic virus	Hops
Algerian navel orange virus	Rutaceae
American hop latent virus	Hops
Andean potato latent virus	Potato
Andean potato mild mosaic virus	Potato
Anthoxanthum latent blanching hordeivirus	Clonal grasses
Anthoxanthum latent blanching virus	Clonal grasses
Anthoxanthum mosaic potyvirus	Clonal grasses
Anthoxanthum mosaic virus	Clonal grasses
Apple dimple fruit viroid	Pome/Figs/Pomegranate
Apple fruit crinkle apscaviroid	Hops/Pome
Apple fruit crinkle viroid	Hops/Pome
Apple hammerhead viroid	Pome
Apple necrotic mosaic virus	Pome
Apple rubbery wood associated virus 1	Pome
Apple rubbery wood associated virus 2	Pome
Apple scar skin viroid	Pome/Stonefruit
Apricot latent ringspot nepovirus	Stonefruit
Apricot latent ringspot virus	Stonefruit
Arkansas fig virus 1	Figs
Arkansas fig virus 2	Figs
Artichoke Italian latent virus	Vitis
Asian prunus foveavirus 1	Stonefruit
Asian prunus foveavirus 3	Stonefruit
Asian prunus virus 1	Stonefruit
Asian prunus virus 3	Stonefruit
Avocado sunblotch viroid	Avocado
Bamboo mosaic potexvirus	Clonal grasses
Bamboo mosaic virus	Clonal grasses
Barley stripe mosaic hordeivirus	Grains
Barley stripe mosaic virus	Grains
Barley yellow dwarf virus	Rice
Bean common mosaic virus	Peanuts
Beet curly top virus	Potato
Bermuda grass etched line marafivirus	Clonal grasses
Bermuda grass etched line virus	Clonal grasses
Bidens mottle virus	Lupins
Blackberry chlorotic ringspot ilarvirus	Rubus
Blackberry chlorotic ringspot virus	Pome/Rubus
Blackberry leaf mottle associated virus	Rubus
Blackberry virus E	Rubus
Blackberry virus S	Rubus
Blackberry virus Y	Rubus
Blackberry yellow vein associated virus	Rubus
Blackcurrant reversion nepovirus	Ribes
Blackcurrant reversion virus	Ribes
Blackcurrant yellows Ribes
Blueberry fruit drop associated virus	Blueberry
Blueberry green mosaic associated virus	Blueberry
Blueberry latent spherical nepovirus	Blueberry
Blueberry latent spherical virus	Blueberry
Blueberry leaf mottle nepovirus	Blueberry/Vitis
Blueberry leaf mottle virus	Blueberry/Vitis
Blueberry mosaic associated ophiovirus	Blueberry
Blueberry mosaic associated virus	Blueberry
Blueberry necrotic ring blotch virus	Blueberry
Blueberry red ringspot soymovirus	Blueberry
Blueberry red ringspot virus	Blueberry
Blueberry scorch carlavirus	Blueberry
Blueberry scorch virus	Blueberry
Blueberry shock ilarvirus	Blueberry
Blueberry shock virus	Blueberry
Blueberry shoestring sobemovirus	Blueberry
Blueberry shoestring virus	Blueberry
Blueberry virus A	Blueberry
Blueberry virus T	Blueberry
Broad bean mottle virus	Legumes
Broad bean stain comovirus	Legumes
Broad bean stain virus	Legumes
Broad bean true mosaic comovirus	Legumes
Broad bean true mosaic virus	Legumes
Brome mosaic bromovirus	Clonal grasses
Brome mosaic virus	Clonal grasses
Cadang cadang viroid	Palms
Canary reed mosaic potyvirus	Clonal grasses
Canary reed mosaic virus	Clonal grasses
Carnation Italian ringspot tombusvirus	Stonefruit
Carnation Italian ringspot virus	Stonefruit
Cassava American latent nepovirus	Cassava
Cassava American latent virus	Cassava
Cassava brown streak ipomovirus	Cassava
Cassava brown streak virus	Cassava
Cassava Colombian symptomless tentative potexvirus	Cassava
Cassava Colombian symptomless tentative virus	Cassava
Cassava common mosaic potexvirus	Cassava
Cassava common mosaic virus	Cassava
Cassava frogskin virus	Cassava
Cassava green mottle nepovirus	Cassava
Cassava green mottle virus	Cassava
Cassava Ivorian bacilliform anulavirus	Cassava
Cassava Ivorian bacilliform virus	Cassava
Cassava vein mosaic cavemovirus	Cassava
Cassava vein mosaic virus	Cassava
Cassava virus X potexvirus	Cassava
Cassava virus X virus	Cassava
Cassava Colombian symptomless virus	Cassava
Caucasus prunus virus	Stonefruit
Cereal northern mosaic rhabdovirus	Clonal grasses
Cereal northern mosaic virus	Clonal grasses
Cherry rusty mottle associated virus	Stonefruit
Cherry associated luteovirus	Stonefruit
Cherry associated virus	Stonefruit
Cherry Hungarian rasp leaf virus	Stonefruit
Cherry leaf roll nepovirus	Blueberry/Ribes/Elms/Vitis/Hops/Kiwifruit/Olives/Pome/Rubus/Stonefruit/Walnut/Pomegranate
Cherry leaf roll virus	Blueberry/Ribes/Elms/Vitis/Hops/Kiwifruit/Olives/Pome/Rubus/Stonefruit/Walnut/Pomegranate
Cherry leafroll virus	Blueberry/Ribes/Elms/Vitis/Hops/Kiwifruit/Olives/Pome/Rubus/Stonefruit/Walnut
Cherry mottle leaf trichovirus	Stonefruit
Cherry mottle leaf virus	Stonefruit
Cherry rasp leaf nepovirus	Malus/Rubus/Stonefruit
Cherry rasp leaf virus	Malus/Rubus/Stonefruit
Cherry robigovirus 5	Stonefruit
Cherry rosette virus	Stonefruit
Cherry twisted leaf associated virus	Stonefruit
Cherry virus F	Stonefruit
Cherry virus T	Stonefruit
Cherry virus Trakiya	Stonefruit
Cherry virus Turkey	Stonefruit
Citrus apscaviroid V	Rutaceae
Citrus apscaviroid VI	Rutaceae
Citrus bark cracking cocadviroid	Rutaceae
Citrus bark cracking viroid	Rutaceae
Citrus bent leaf apscaviroid	Rutaceae
Citrus bent leaf viroid	Rutaceae
Citrus cachexia viroid	Rutaceae
Citrus chlorotic dwarf associated virus	Rutaceae
Citrus concave gum associated virus	Rutaceae
Citrus coguvirus	Rutaceae
Citrus dwarfing apscaviroid	Rutaceae
Citrus dwarfing viroid	Rutaceae
Citrus exocortis pospiviroid	Rutaceae
Citrus exocortis viroid	Rutaceae
Citrus leaf blotch citrivirus	Rutaceae
Citrus leaf blotch virus	Rutaceae
Citrus leaf rugose ilarvirus	Rutaceae
Citrus leaf rugose virus	Rutaceae
Citrus leprosis rhabdovirus	Rutaceae
Citrus leprosis virus	Rutaceae
Citrus ringspot virus	Rutaceae
Citrus seed borne virus	Rutaceae
Citrus sudden death associated virus	Rutaceae
Citrus tatter leaf capillovirus	Rutaceae
Citrus tatter leaf virus	Rutaceae
Citrus tristeza closterovirus	Rutaceae
Citrus tristeza virus	Rutaceae
Citrus variegation ilarvirus	Rutaceae
Citrus variegation virus	Rutaceae
Citrus vein enation virus	Rutaceae
Citrus viroid Ia	Rutaceae
Citrus viroid Ib	Rutaceae
Citrus viroid IIa	Rutaceae
Citrus viroid IIb	Rutaceae
Citrus viroid IIc	Rutaceae
Citrus viroid III	Rutaceae
Citrus viroid IIIa	Rutaceae
Citrus viroid IIIa	Rutaceae
Citrus viroid IIIb	Rutaceae
Citrus viroid IIIb	Rutaceae
Citrus viroid IIIc	Rutaceae
Citrus viroid IIIc	Rutaceae
Citrus viroid IV	Rutaceae
Citrus viroid OS	Rutaceae
Citrus viroid V	Rutaceae
Citrus viroid VI	Rutaceae
Citrus yellow mosaic badnavirus	Rutaceae
Citrus yellow mosaic virus	Rutaceae
Citrus yellow mottle virus	Rutaceae
Citrus yellow vein clearing virus	Rutaceae
Cocksfoot mild mosaic panicovirus	Clonal grasses
Cocksfoot mild mosaic virus	Clonal grasses
Cocksfoot streak potyvirus	Clonal grasses
Cocksfoot streak virus	Clonal grasses
Coconut tinangaja viroid	Palms
Colocasia bobone disease associated cytorhabdovirus	Taro
Colocasia bobone disease associated virus	Taro
Concave gum virus	Rutaceae
Cotton leaf curl Gezira virus	Hibiscus/Papaya
Cotton leaf curl virus	Hibiscus/Papaya
Cotton leafroll dwarf virus	Cotton
Crinkly leaf virus	Rutaceae
Cynodon chlorotic streak rhabdovirus	Clonal grasses
Cynodon chlorotic streak virus	Clonal grasses
Dasheen mosaic potyvirus	Taro
Dasheen mosaic virus	Taro
East African cassava mosaic begomovirus	Cassava
East African cassava mosaic Cameroon begomovirus	Cassava
East African cassava mosaic Cameroon virus	Cassava
East African cassava mosaic Malawi begomovirus	Cassava
East African cassava mosaic Malawi virus	Cassava
East African cassava mosaic virus	Cassava
East African cassava mosaic Zanzibar begomovirus	Cassava
East African cassava mosaic Zanzibar virus	Cassava
East Asian passiflora potyvirus	Passionfruit
East Asian passiflora virus	Passionfruit
Eggplant mottled dwarf virus	Potato
Elm mottle virus	Elm
Epirus cherry virus	Stonefruit
Festuca leaf streak rhabdovirus	Clonal grasses
Festuca leaf streak virus	Clonal grasses
Festuca necrosis closterovirus	Clonal grasses
Festuca necrosis virus	Clonal grasses
Fig fleck associated virus	Figs
Fig leaf mottle associated virus 1	Figs
Fig leaf mottle associated virus 2	Figs
Fig mild mottle associated virus	Figs
Fiji disease virus	Sugarcane
Foxtail mosaic potexvirus	Clonal grasses/Grains
Foxtail mosaic virus	Clonal grasses/Grains
Fragaria chiloensis latent virus	Fragaria
Gooseberry vein banding associated badnavirus	Ribes
Gooseberry vein banding associated virus	Ribes
Grapevine Ajinashika virus	Grapevines
Grapevine Anatolian ringspot virus	Vitis
Grapevine angular mosaic associated virus	Vitis
Grapevine angular mosaic virus	Vitis
Grapevine asteroid mosaic associated virus	Vitis
Grapevine berry inner necrosis virus	Vitis
Grapevine Bulgarian latent virus	Vitis
Grapevine chrome mosaic virus	Vitis
Grapevine deformation virus	Vitis
Grapevine fabavirus	Vitis
Grapevine fanleaf virus	Vitis
Grapevine leafroll associated virus 13	Vitis
Grapevine leafroll associated virus 7	Vitis
Grapevine line pattern virus	Vitis
Grapevine red blotch associated virus	Vitis
Grapevine red blotch virus	Vitis
Grapevine Roditis leaf discolouration associated virus	Vitis
Grapevine Roditis leaf discoloration associated virus	Vitis
Grapevine Tunisian ringspot virus	Vitis
Grapevine vein clearing virus	Vitis
Grapevine virus B	Vitis
Grapevine virus D	Vitis
Grapevine virus E	Vitis
Grapevine virus G	Vitis
Grapevine virus H	Vitis
Grapevine virus I	Vitis
Grapevine virus J	Vitis
Grapevine virus K	Vitis
Grapevine virus L	Vitis
Grapevine virus M	Vitis
Grapevine virus T	Vitis
Groundnut bud necrosis virus	Catharanthus roseus/Potato/Taro
Groundnut ringspot virus	Potato
Guinea grass mosaic potyvirus	Clonal grasses
Guinea grass mosaic virus	Clonal grasses
Holcus lanatus yellowing rhabdovirus	Clonal grasses
Holcus lanatus yellowing virus	Clonal grasses
Hop latent viroid Cannabis
Holcus streak potyvirus	Clonal grasses
Holcus streak virus	Clonal grasses
Hop stunt hostuviroid	Rutaceae/Hops
Hop stunt viroid	Rutaceae/Hops
Humulus japonicus latent virus	Hops
Indian cassava mosaic begomovirus	Cassava
Indian cassava mosaic virus	Cassava
Indian peanut clump potyvirus	Clonal grasses
Indian peanut clump virus	Clonal grasses
Konjac mosaic virus	Taro
Lupinus mosaic virus	Lupins
Maize chlorotic mottle machlomovirus	Clonal grasses/Grains
Maize chlorotic mottle potyvirus	Clonal grasses/Grains
Maize chlorotic mottle virus	Clonal grasses/Grains/Sugarcane
Maize chlorotic mottle virus 1	Clonal grasses/Grains/Sugarcane
Maize dwarf mosaic potyvirus	Clonal grasses/Grains
Maize dwarf mosaic virus	Clonal grasses/Grains
Maize mosaic nucleorhabdovirus	Clonal grasses/Grains
Maize mosaic rhabdovirus B	Clonal grasses
Maize mosaic virus B	Clonal grasses
Maize rough dwarf fijivirus	Clonal grasses
Maize rough dwarf virus	Clonal grasses
Maize streak geminivirus	Clonal grasses
Maize streak virus	Clonal grasses
Maize white line mosaic virus	Grains
Millet streak geminivirus	Clonal grasses
Millet streak virus	Clonal grasses
Miscanthus streak mastrevirus	Clonal grasses
Miscanthus streak virus	Clonal grasses
Molinia streak sobemovirus	Clonal grasses
Molinia streak virus	Clonal grasses
Moroccan watermelon mosaic potyvirus	Papaya
Moroccan watermelon mosaic virus	Papaya
Mulberry green mosaic virus	Mulberry
Mulberry latent carlavirus	Mulberry
Mulberry latent virus	Mulberry
Mulberry mosaic dwarf viroid	Mulberry
Mulberry small circular viroid	Mulberry
Mulberry small circular viroid like RNA 1	Mulberry
Mulberry small circular viroid like RNA 1	Mulberry
Mulberry mosaic leaf roll associated nepovirus	Mulberry
Mulberry mosaic leaf roll associated virus	Mulberry
Mulberry mosaic virus	Mulberry
Mulberry ringspot nepovirus	Mulberry
Mulberry ringspot virus	Mulberry
Mulberry vein banding tospovirus	Mulberry
Mulberry vein banding virus	Mulberry
Mulberry yellow net vein virus	Mulberry
Myrobalan latent ringspot nepovirus	Stonefruit
Myrobalan latent ringspot virus	Stonefruit
Nectarine marafivirus M	Stonefruit
Oat necrotic mottle potyvirus	Clonal grasses
Oat necrotic mottle virus	Clonal grasses
Olive latent 1 sobemovirus	Olives
Olive latent 2 ourmiavirus	Olives
Olive latent ringspot nepovirus	Olives
Olive latent ringspot virus	Olives
Olive latent virus 1	Olives
Olive latent virus 2	Olives
Olive latent virus 3	Olives
Olive leaf yellowing associated closterovirus	Olives
Olive leaf yellowing associated virus	Olives
Olive mild mosaic necrovirus	Olives
Olive mild mosaic virus	Olives
Olive semi latent virus	Olives
Olive semilatent virus	Olives
Olive vein yellowing associated potexvirus	Olives
Olive vein yellowing associated virus	Olives
Olive yellow mottling and decline associated virus	Olives
Panicum mosaic sobemovirus	Clonal grasses
Panicum mosaic virus	Clonal grasses
Papaya apical necrosis rhabdovirus	Papaya
Papaya apical necrosis virus	Papaya
Papaya droopy necrosis rhabdovirus	Papaya
Papaya droopy necrosis virus	Papaya
Papaya leaf crumple virus	Catharanthus roseus
Papaya leaf curl geminivirus	Papaya
Papaya leaf curl virus	Papaya
Papaya leaf distortion mosaic potyvirus	Papaya
Papaya leaf distortion mosaic virus	Papaya
Papaya lethal yellowing sobemovirus	Papaya
Papaya lethal yellowing virus	Papaya
Papaya meleira virus	Papaya
Papaya mosaic potexvirus	Papaya
Papaya mosaic virus	Papaya
Papaya ringspot potyvirus	Papaya
Papaya ringspot potyvirus – Type P3	Papaya
Papaya ringspot virus	Papaya
Passiflora chlorosis potyvirus	Passionfruit
Passiflora chlorosis virus	Passionfruit
Passion fruit yellow mosaic virus	Passionfruit
Passionfruit crinkle potyvirus	Passionfruit
Passionfruit crinkle virus	Passionfruit
Passionfruit ringspot potyvirus	Passionfruit
Passionfruit ringspot virus	Passionfruit
Passionfruit severe leaf distortion begomovirus	Passionfruit
Passionfruit severe leaf distortion virus	Passionfruit
Passionfruit Sri Lankan mottle potyvirus	Passionfruit
Passionfruit Sri Lankan mottle virus	Passionfruit
Passionfruit vein clearing rhabdovirus	Passionfruit
Passionfruit vein clearing virus	Passionfruit
Passionfruit yellow mosaic tymoviridae	Passionfruit
Passionfruit yellow mosaic tymovirus	Passionfruit
Passionfruit yellow mosaic virus	Passionfruit
Pea early browning tobravirus	Legumes/Lupins
Pea early browning virus	Legumes/Lupins
Pea early browning virus	Legumes/Lupins
Pea enation mosaic virus	Lupins
Pea seed borne mosaic virus	Legumes
Peach chlorotic leaf spot virus	Stonefruit
Peach chlorotic mottle virus	Stonefruit
Peach enation nepovirus	Stonefruit
Peach enation virus	Stonefruit
Peach leaf pitting associated virus	Stonefruit
Peach maravirus D	Stonefruit
Peach mosaic trichovirus	Stonefruit
Peach mosaic virus	Stonefruit
Peach rosette mosaic nepovirus	Blueberry/Vitis/Stonefruit
Peach rosette mosaic virus	Blueberry/Vitis/Stonefruit
Peach virus D	Stonefruit
Peanut bud necrosis virus	Peanuts
Peanut clump furovirus	Grains/Peanuts
Peanut clump pecluvirus	Grains/Peanuts
Peanut clump virus	Grains/Sugarcane
Peanut stripe potyvirus	Lupins/Peanuts
Peanut stripe virus	Lupins/Peanuts
Peanut stunt cucumovirus	Lupins/Peanuts
Peanut stunt virus	Lupins/Peanuts
Pear chlorotic leaf spot associated virus	Pome
Pearl millet mosaic potyvirus	Clonal grasses
Pearl millet mosaic virus	Clonal grasses
Pepino mosaic virus	Potato
Petunia asteroid mosaic tombusvirus	Vitis/Stonefruit/Hops
Petunia asteroid mosaic virus	Vitis/Stonefruit/Hops
Plum pox potyvirus	Stonefruit
Plum pox virus	Stonefruit
Plum viroid 1	Stonefruit
Potato black ringspot virus	Potato
Potato deforming mosaic virus	Potato
Potato latent virus	Potato
Potato mop top virus	Potato
Potato rough dwarf virus	Potato
Potato spindle tuber viroid	Avocado/ Potato
Potato virus B	Potato
Potato virus H	Potato
Potato virus M	Potato
Potato virus S	Potato
Potato virus S – Andean strain	Potato
Potato virus V	Potato
Potato virus Y	Potato
Potato yellow blotch virus	Potato
Potato yellow dwarf nucleorhabdovirus	Potato
Potato yellow dwarf virus	Potato
Potato yellow vein virus	Catharanthus roseus/Potato
Potato yellowing virus	Potato
Prunus virus I	Stonefruit
Prunus virus T	Stonefruit
Radish mosaic virus	Brassica oleracea
Ramu stunt virus	Sugarcane
Raspberry latent virus	Rubus
Raspberry leaf blotch virus	Rubus
Raspberry leaf curl virus Rubus
Raspberry ringspot nepovirus	Ribes/Vitis/Stonefruit/Fragaria
Raspberry ringspot virus	Ribes/Vitis/Stonefruit/Fragaria
Raspberry vein chlorosis virus	Rubus
Rice black streaked dwarf fijivirus	Clonal grasses/Rice
Rice black streaked dwarf virus	Clonal grasses/Rice
Rice dwarf virus	Clonal grasses/Rice
Rice hoja blanca tenuivirus	Clonal grasses/Rice
Rice hoja blanca virus	Clonal grasses/Rice
Rice stripe tenuivirus	Clonal grasses/Rice
Rice stripe virus	Clonal grasses/Rice
Rice tungro bacilliform badnavirus	Clonal grasses/Rice
Rice tungro bacilliform virus	Clonal grasses/Rice
Rice tungro spherical virus	Clonal grasses/Rice
Rice tungro spherical waikavirus	Clonal grasses/Rice
Rubus yellow net virus	Rubus
Satsuma dwarf sadwavirus	Rutaceae
Satsuma dwarf virus	Rutaceae
Solanum apical leaf curling virus	Potato
Sorghum mosaic potyvirus	Grains/Conal grasses/Sugarcane
Sorghum mosaic virus	Grains/Clonal grasses/Sugarcane
South African cassava mosaic begomovirus	Cassava
South African cassava mosaic virus	Cassava
Stocky prune virus	Stonefruit
Strawberry chlorotic fleck associated virus	Fragaria
Strawberry chlorotic fleck virus	Fragaria
Strawberry crinivirus 3	Fragaria
Strawberry crinivirus 4	Fragaria
Strawberry latent C rhabdovirus	Fragaria
Strawberry latent C virus	Fragaria
Strawberry latent ringspot nepovirus	Ribes/Rubus/Hops/Blueberry/Vitis/Olives/Stonefruit/Fragaria/Prunus
Strawberry latent ringspot sadwavirus	Ribes/Rubus/Hops/Blueberry/Vitis/Olives/Stonefruit/Fragaria/Prunus
Strawberry latent ringspot virus	Ribes/Rubus/Hops/Blueberry/Vitis/Olives/Stonefruit/Fragaria/Prunus
Strawberry leaf curl virus	Fragaria
Strawberry polerovirus 1	Fragaria
Strawberry pseudo mild yellow edge virus	Fragaria
Sugarcane mosaic virus	Sugarcane
Sugarcane streak mosaic virus	Sugarcane
Sugarcane streak virus	Sugarcane
Sunflower chlorotic mottle potyvirus	Sunflower
Sunflower chlorotic mottle virus	Sunflower
Sunflower mosaic potyvirus	Sunflower
Sunflower mosaic virus	Sunflower
Sweet potato caulimovirus	Sweet potato
Sweet potato chlorotic fleck virus	Sweet potato
Sweet potato chlorotic stunt virus	Sweet potato
Sweet potato latent virus	Sweet potato
Sweet potato leaf curl virus	Sweet potato
Sweet potato leaf speckling virus	Sweet potato
Sweet potato mild speckling virus	Sweet potato
Sweet potato mild speckling virus C8	Sweet potato
Sweet potato ringspot virus	Sweet potato
Sweet potato vein mosaic virus	Sweet potato
Sweet potato virus	Sweet potato
Sweet potato virus 2	Sweet potato
Sweet potato virus C6	Sweet potato
Sweet potato yellow dwarf virus	Sweet potato
Taro reovirus	Taro
Taro vein chlorosis rhabdovirus	Taro
Taro vein chlorosis virus	Taro
Taro virus	Taro
Tobacco necrosis alphanecrovirus	Vitis/Hops/Rubus/Stonefruit
Tobacco necrosis virus	Vitis/Hops/Rubus/Stonefruit
Tobacco necrosis virus A	Potato
Tobacco necrosis virus D	Potato/Fragaria
Tomato black ring nepovirus	Ribes/Vitis/Lupins/Potato/Rubus/Stonefruit/Fragaria
Tomato black ring virus	Ribes/Vitis/Lupins/Potato/Rubus/Stonefruit/Fragaria
Tomato bushy stunt tombusvirus	Pome/Stonefruit
Tomato bushy stunt virus	Pome/Stonefruit
Tomato chlorosis virus	Potato
Tomato chlorotic spot virus	Catharanthus roseus/Potato
Tomato leaf curl Albatinah begomovirus	Papaya
Tomato leaf curl Albatinah virus	Papaya
Tomato leaf curl New Delhi virus	Potato
Tomato mottle Taino virus	Potato
Tomato ring spot virus	Blueberry/Ribes/Vitis/Pome/Rubus/Stonefruit/Fragaria/Pomegranate
Tomato ringspot nepovirus	Blueberry/Ribes/Vitis/Pome/Rubus/Stonefruit/Fragaria/Pomegranate
Tomato ringspot virus	Blueberry/Ribes/Vitis/Pome/Rubus/Stonefruit/Fragaria/Pomegranate
Tomato yellow fruit ring virus	Potato
Tomato yellow mosaic virus	Potato
Tomato zonate spot tospovirus	Taro
Tomato zonate spot virus	Taro
Tulare apple mosaic virus	Hazelnuts/Pome
Wheat dwarf geminivirus A	Clonal grasses
Wheat dwarf virus	Clonal grasses
Wheat dwarf virus A	Clonal grasses
Wheat soilbome mosaic furovirus	Clonal grasses
Wheat soilbome mosaic virus	Clonal grasses
Wheat yellow leaf closterovirus	Clonal grasses
Wheat yellow leaf virus	Clonal grasses
Wild potato mosaic virus	Potato
Zoysia mosaic potyvirus	Clonal grasses
Zoysia mosaic virus	Clonal grasses
